,network_size,zipf,algorithm,adjustment_cost,routing_cost,total_cost,alpha,window_size,sliding_offset
0,100,1.1,splaynet,52778736,7838928,60617664,,,
1,100,1.1,lazy,7511400,7838928,15350328,100,,
2,100,1.1,sliding,7507900,7835454,15343354,,100,10
3,100,1.1,sliding_no_reset,7517200,7844857,15362057,,100,10
4,100,1.1,sliding,7507900,7835454,15343354,,100,25
5,100,1.1,sliding_no_reset,7517200,7844857,15362057,,100,25
6,100,1.1,sliding,7507900,7835454,15343354,,100,40
7,100,1.1,sliding_no_reset,7517200,7844857,15362057,,100,40
8,100,1.1,sliding,7507900,7835454,15343354,,100,50
9,100,1.1,sliding_no_reset,7517200,7844857,15362057,,100,50
10,100,1.1,sliding,7507900,7835454,15343354,,100,60
11,100,1.1,sliding_no_reset,7517200,7844857,15362057,,100,60
12,100,1.1,sliding,7507900,7835454,15343354,,100,75
13,100,1.1,sliding_no_reset,7517200,7844857,15362057,,100,75
14,100,1.1,sliding,7507900,7835454,15343354,,100,90
15,100,1.1,sliding_no_reset,7517200,7844857,15362057,,100,90
16,100,1.1,sliding,7507900,7835454,15343354,,100,100
17,100,1.1,sliding_no_reset,7517200,7844857,15362057,,100,100
18,100,1.25,splaynet,50236214,6887722,57123936,,,
19,100,1.25,lazy,6614000,6887722,13501722,100,,
20,100,1.25,sliding,6620700,6894108,13514808,,100,10
21,100,1.25,sliding_no_reset,6610600,6884912,13495512,,100,10
22,100,1.25,sliding,6620700,6894108,13514808,,100,25
23,100,1.25,sliding_no_reset,6610600,6884912,13495512,,100,25
24,100,1.25,sliding,6620700,6894108,13514808,,100,40
25,100,1.25,sliding_no_reset,6610600,6884912,13495512,,100,40
26,100,1.25,sliding,6620700,6894108,13514808,,100,50
27,100,1.25,sliding_no_reset,6610600,6884912,13495512,,100,50
28,100,1.25,sliding,6620700,6894108,13514808,,100,60
29,100,1.25,sliding_no_reset,6610600,6884912,13495512,,100,60
30,100,1.25,sliding,6620700,6894108,13514808,,100,75
31,100,1.25,sliding_no_reset,6610600,6884912,13495512,,100,75
32,100,1.25,sliding,6620700,6894108,13514808,,100,90
33,100,1.25,sliding_no_reset,6610600,6884912,13495512,,100,90
34,100,1.25,sliding,6620700,6894108,13514808,,100,100
35,100,1.25,sliding_no_reset,6610600,6884912,13495512,,100,100
36,100,1.5,splaynet,46551952,5356646,51908598,,,
37,100,1.5,lazy,5159900,5356646,10516546,100,,
38,100,1.5,sliding,5197500,5395053,10592553,,100,10
39,100,1.5,sliding_no_reset,5162400,5358162,10520562,,100,10
40,100,1.5,sliding,5197500,5395053,10592553,,100,25
41,100,1.5,sliding_no_reset,5162400,5358162,10520562,,100,25
42,100,1.5,sliding,5197500,5395053,10592553,,100,40
43,100,1.5,sliding_no_reset,5162400,5358162,10520562,,100,40
44,100,1.5,sliding,5197500,5395053,10592553,,100,50
45,100,1.5,sliding_no_reset,5162400,5358162,10520562,,100,50
46,100,1.5,sliding,5197500,5395053,10592553,,100,60
47,100,1.5,sliding_no_reset,5162400,5358162,10520562,,100,60
48,100,1.5,sliding,5197500,5395053,10592553,,100,75
49,100,1.5,sliding_no_reset,5162400,5358162,10520562,,100,75
50,100,1.5,sliding,5197500,5395053,10592553,,100,90
51,100,1.5,sliding_no_reset,5162400,5358162,10520562,,100,90
52,100,1.5,sliding,5197500,5395053,10592553,,100,100
53,100,1.5,sliding_no_reset,5162400,5358162,10520562,,100,100
54,100,1.75,splaynet,44236970,4274522,48511492,,,
55,100,1.75,lazy,4131700,4274522,8406222,100,,
56,100,1.75,sliding,4169300,4314590,8483890,,100,10
57,100,1.75,sliding_no_reset,4134500,4277618,8412118,,100,10
58,100,1.75,sliding,4169300,4314590,8483890,,100,25
59,100,1.75,sliding_no_reset,4134500,4277618,8412118,,100,25
60,100,1.75,sliding,4169300,4314590,8483890,,100,40
61,100,1.75,sliding_no_reset,4134500,4277618,8412118,,100,40
62,100,1.75,sliding,4169300,4314590,8483890,,100,50
63,100,1.75,sliding_no_reset,4134500,4277618,8412118,,100,50
64,100,1.75,sliding,4169300,4314590,8483890,,100,60
65,100,1.75,sliding_no_reset,4134500,4277618,8412118,,100,60
66,100,1.75,sliding,4169300,4314590,8483890,,100,75
67,100,1.75,sliding_no_reset,4134500,4277618,8412118,,100,75
68,100,1.75,sliding,4169300,4314590,8483890,,100,90
69,100,1.75,sliding_no_reset,4134500,4277618,8412118,,100,90
70,100,1.75,sliding,4169300,4314590,8483890,,100,100
71,100,1.75,sliding_no_reset,4134500,4277618,8412118,,100,100
72,100,2.0,splaynet,42603148,3504085,46107233,,,
73,100,2.0,lazy,3396100,3504085,6900185,100,,
74,100,2.0,sliding,3432100,3539776,6971876,,100,10
75,100,2.0,sliding_no_reset,3401000,3509208,6910208,,100,10
76,100,2.0,sliding,3432100,3539776,6971876,,100,25
77,100,2.0,sliding_no_reset,3401000,3509208,6910208,,100,25
78,100,2.0,sliding,3432100,3539776,6971876,,100,40
79,100,2.0,sliding_no_reset,3401000,3509208,6910208,,100,40
80,100,2.0,sliding,3432100,3539776,6971876,,100,50
81,100,2.0,sliding_no_reset,3401000,3509208,6910208,,100,50
82,100,2.0,sliding,3432100,3539776,6971876,,100,60
83,100,2.0,sliding_no_reset,3401000,3509208,6910208,,100,60
84,100,2.0,sliding,3432100,3539776,6971876,,100,75
85,100,2.0,sliding_no_reset,3401000,3509208,6910208,,100,75
86,100,2.0,sliding,3432100,3539776,6971876,,100,90
87,100,2.0,sliding_no_reset,3401000,3509208,6910208,,100,90
88,100,2.0,sliding,3432100,3539776,6971876,,100,100
89,100,2.0,sliding_no_reset,3401000,3509208,6910208,,100,100
90,100,2.25,splaynet,41525232,2963925,44489157,,,
91,100,2.25,lazy,2880800,2963925,5844725,100,,
92,100,2.25,sliding,2911300,2994861,5906161,,100,10
93,100,2.25,sliding_no_reset,2884500,2968949,5853449,,100,10
94,100,2.25,sliding,2911300,2994861,5906161,,100,25
95,100,2.25,sliding_no_reset,2884500,2968949,5853449,,100,25
96,100,2.25,sliding,2911300,2994861,5906161,,100,40
97,100,2.25,sliding_no_reset,2884500,2968949,5853449,,100,40
98,100,2.25,sliding,2911300,2994861,5906161,,100,50
99,100,2.25,sliding_no_reset,2884500,2968949,5853449,,100,50
100,100,2.25,sliding,2911300,2994861,5906161,,100,60
101,100,2.25,sliding_no_reset,2884500,2968949,5853449,,100,60
102,100,2.25,sliding,2911300,2994861,5906161,,100,75
103,100,2.25,sliding_no_reset,2884500,2968949,5853449,,100,75
104,100,2.25,sliding,2911300,2994861,5906161,,100,90
105,100,2.25,sliding_no_reset,2884500,2968949,5853449,,100,90
106,100,2.25,sliding,2911300,2994861,5906161,,100,100
107,100,2.25,sliding_no_reset,2884500,2968949,5853449,,100,100
108,100,2.5,splaynet,40635194,2564776,43199970,,,
109,100,2.5,lazy,2499800,2564776,5064576,100,,
110,100,2.5,sliding,2521700,2588130,5109830,,100,10
111,100,2.5,sliding_no_reset,2504900,2570969,5075869,,100,10
112,100,2.5,sliding,2521700,2588130,5109830,,100,25
113,100,2.5,sliding_no_reset,2504900,2570969,5075869,,100,25
114,100,2.5,sliding,2521700,2588130,5109830,,100,40
115,100,2.5,sliding_no_reset,2504900,2570969,5075869,,100,40
116,100,2.5,sliding,2521700,2588130,5109830,,100,50
117,100,2.5,sliding_no_reset,2504900,2570969,5075869,,100,50
118,100,2.5,sliding,2521700,2588130,5109830,,100,60
119,100,2.5,sliding_no_reset,2504900,2570969,5075869,,100,60
120,100,2.5,sliding,2521700,2588130,5109830,,100,75
121,100,2.5,sliding_no_reset,2504900,2570969,5075869,,100,75
122,100,2.5,sliding,2521700,2588130,5109830,,100,90
123,100,2.5,sliding_no_reset,2504900,2570969,5075869,,100,90
124,100,2.5,sliding,2521700,2588130,5109830,,100,100
125,100,2.5,sliding_no_reset,2504900,2570969,5075869,,100,100
